ALX	= "countries/Alabama.txt"
AKX = "countries/Alaska.txt"
AZX = "countries/Arizona.txt"
ARX = "countries/Arkansas.txt"
CAX = "countries/California.txt"
COX = "countries/Colorado.txt"
CTX = "countries/Connecticut.txt"
DEX = "countries/Delaware.txt"
FLX = "countries/Florida.txt"
GAX = "countries/GeorgiaState.txt" # because there's already a country called Georgia
HIX = "countries/Hawaii.txt"
IDX = "countries/Idaho.txt"
ILX = "countries/Illinois.txt"
INX = "countries/Indiana.txt"
IAX = "countries/Iowa.txt"
KSX = "countries/Kansas.txt"
KYX = "countries/Kentucky.txt"
LAX = "countries/Louisiana.txt"
MEZ = "countries/Maine.txt" # not MEX because mexico
MDX = "countries/Maryland.txt"
MAX = "countries/Massachusetts.txt"
MIX = "countries/Michigan.txt"
MNX = "countries/Minnesota.txt"
MSX = "countries/Mississippi.txt"
MOX = "countries/Missouri.txt"
MTX = "countries/Montana.txt"
NEX = "countries/Nebraska.txt"
NVX = "countries/Nevada.txt"
NHX = "countries/NewHampshire.txt"
NJX = "countries/NewJersey.txt"
NMX = "countries/NewMexico.txt"
NYX = "countries/NewYork.txt"
NCX = "countries/NorthCarolina.txt"
NDX = "countries/NorthDakota.txt"
OHX = "countries/Ohio.txt"
OKX = "countries/Oklahoma.txt"
ORX = "countries/Oregon.txt"
PAX = "countries/Pennsylvania.txt"
RIX = "countries/RhodeIsland.txt"
SCX = "countries/SouthCarolina.txt"
SDX = "countries/SouthDakota.txt"
TNX = "countries/Tennessee.txt"
TXX = "countries/Texas.txt"
UTX = "countries/Utah.txt"
VTX = "countries/Vermont.txt"
VAX = "countries/Virginia.txt"
WAX = "countries/Washington.txt"
WVX = "countries/WestVirginia.txt"
WIX = "countries/Wisconsin.txt"
WYX = "countries/Wyoming.txt"

#####

CSC = "countries/Cascadia.txt"
CSA = "countries/CSA.txt"
GPL = "countries/GreatPlains.txt"
NWN = "countries/NewEngland.txt"
PRX = "countries/PuertoRico.txt"
RKY = "countries/Rockies.txt"
RST = "countries/RustBelt.txt"

#####

ABX = "countries/Alberta.txt"
BCX = "countries/British Columbia.txt"
MBX = "countries/Manitoba.txt"
NBX = "countries/New Brunswick.txt"
NLX = "countries/Newfoundland.txt"
NSX = "countries/Nova Scotia.txt"
NTX = "countries/Northwest Territories.txt"
ONX = "countries/Ontario.txt"
PEX = "countries/Prince Edward Island.txt"
QCX = "countries/Quebec.txt"
SKX = "countries/Saskatchewan.txt"
YTX = "countries/Yukon.txt"

NIR = "countries/Northern Ireland.txt"
SCO = "countries/Scotland.txt"
WAL = "countries/Wales.txt"

BAV = "countries/Bavaria.txt"
HAN = "countries/Hanover.txt"
HES = "countries/Hesse.txt"
HLS = "countries/Holstein.txt"
MEC = "countries/Mecklenburg.txt"
OLD = "countries/Oldenburg.txt"
PRS = "countries/Prussia.txt"
RHI = "countries/Rhineland.txt"
SAA = "countries/Saarland.txt"
SAX = "countries/Saxony.txt"
SIL = "countries/Silesia.txt"
THU = "countries/Thuringia.txt"
WPH = "countries/Westphalia.txt"
WUR = "countries/Wurttemberg.txt"

ARA = "countries/Aragon.txt"

GEN = "countries/Genoa.txt"
LOM = "countries/Lombardy.txt"
NAP = "countries/Naples.txt"
RMA = "countries/Rome.txt"
SAR = "countries/Sardinia.txt"
SAV = "countries/Savoy.txt"
SIC = "countries/Sicily.txt"
TUS = "countries/Tuscany.txt"
VNC = "countries/Venice.txt"

ERI = "countries/Eritrea.txt"
SML = "countries/Somaliland.txt"
SOM = "countries/Somalia.txt"

RIO = "countries/RioGrande.txt"
YUC = "countries/Yucatan.txt"

ACR = "countries/Acre.txt"
AMP = "countries/Amapa.txt"
JUL = "countries/Juliana.txt"
PRA = "countries/Para.txt"
PIR = "countries/Piratini.txt"